0,0,0,0,0,0,0,0,0,0,0,0
0,0,0,0,0,0,0,0,0,0,0,0
1,2,3,0,0,0,0,0,0,20,21,22
0,0,4,0,0,0,0,0,0,19,0,0
0,0,5,0,0,0,0,0,0,18,0,0
0,0,6,7,0,0,0,15,16,17,0,0
0,0,0,8,9,0,0,14,0,0,0,0
0,0,0,0,10,11,12,13,0,0,0,0
